111111111111111
100000010000001
100000010000001
100000011111000000111
1000N0010000001
1000000110000001
1111111111111111
