R	1920	1080
NO ./texture/north.xpm
SO ./texture/south.xpm
WE ./texture/east.xpm
EA ./texture/west.xpm
S  ./texture/barrel.xpm
F 220,100,0
C	225,30,0








11111111
10000001
10000001
100N0001
10000001
10000001
11111111
