R	1000	500
NO ./texture/north.xpm
SO ./texture/south.xpm
WE ./texture/east.xpm
EA ./texture/west.xpm
S ./texture/barrel.xpm
F	96, 145 ,22
C	0, 133 ,201


11111111111111111111111111111111111111111111111111111111111111111111111111111111
10000000000000000000000000000000000000000000000000000000000000000000000000000001
10000000000000000000000000000000000000000000000000000000000000000000000000000001
10000000000000000000000000000000000000000000000000000000000000000000000000000001
10000000000000000000000000000000000000000000000000000000000000000000000020000001
10000000000000000111111110000000000000000000000000000000000000000000000000000001
100000000000000001      11111111111111000000000000000000000000000000000000000001
100000000000000001                   1000000000000000000000000000000000000000001
100000000000000001      11111111111111000000000000000000000000000000000000000001
10000000000000000111111110000000000000000000000000000000000000000000000000000001
10000000000000000000000000000000000000000000000000000000000000000000000000000001
10000000000000000000000000000000000000000000000000000000000000000000000000000001
10000000000000000S00000000000000000000000000000000000000000000000000000000000001
10000000000000000000000000000000000000000000000000000000000000000000000000000001
10000000000000002220200000000000000000000000000000020000000000000000000000000001
10000000000000000000000000000000000000000000000000000000000000000000000000000001
10000000000000000000000000000000000000000000000000000000000000000000000000000001
10000000000000000000000000000000000000000000000000000000000000000000000200000001
10000000000000000000000000000000000000000000000000000000000000000000000000000001
10000000000000000000002112000000000000000000000000000000000000000000000000000001
10000000000000000000001  1000000000000000000000000000000000000000000000000000001
10000000000000000000002112000000000000000000000000000000000000000000000000000001
10000000000000000000000000000000000000000000000000000000000000000000000000000001
10000000000000000000000000111110000000000000000000000000000000000000000000000001
100000000000000000000000001   10000000000000000000000000000000000000000000000001
100000000000000000000000001   10000000000000000000000000000000000000000000000001
100000000000000000000000001   10000000000000000000000000000000000000000000000001
111111111111111111111111111   11111111111111111111111111111111111111111111111111
